0 0 0 0 0 0 0 0 0 0 0 0 0 0 0 0 0 0 0 0 0 0 0 0 0 0 0 0 0 0 0 0 0 0 0 0 0 0 0 0 0 0 0 0 0 0 0 0 
0 6 9 9 9 9 15 8 8 8 8 8 8 3 3 3 1 1 1 1 1 1 1 1 3 3 3 3 3 1 1 3 3 1 1 1 1 1 1 1 3 3 3 3 3 1 1 0
0 11 5 5 5 5 12 8 2 2 2 2 2 2 2 2 1 1 1 1 1 1 1 1 3 3 3 3 3 1 1 3 3 1 1 1 1 1 1 1 3 3 3 3 3 1 1 0
0 11 5 5 5 5 12 3 3 3 3 3 3 3 3 3 1 1 1 1 1 1 1 1 3 3 3 3 3 1 1 3 3 1 1 1 1 1 1 1 3 3 3 3 3 1 1 0
0 11 5 5 5 5 12 3 2 2 2 2 2 2 2 2 1 1 1 1 1 1 1 1 3 3 3 3 3 1 1 3 3 1 1 1 1 1 1 1 3 3 3 3 3 1 1 0
0 13 10 10 10 10 14 3 3 3 3 3 3 3 3 3 1 1 1 1 1 1 1 1 3 3 3 3 3 1 1 3 3 1 1 1 1 1 1 1 3 3 3 3 3 1 1 0
0 1 1 1 1 1 1 3 3 3 3 3 3 1 1 3 1 1 1 1 1 1 1 1 3 3 3 3 3 1 1 3 3 1 1 1 1 1 1 1 3 3 3 3 3 1 1 0
0 1 1 1 1 3 1 3 3 3 3 3 1 1 1 3 1 1 1 1 1 1 1 1 3 3 3 3 3 1 1 3 3 1 1 1 1 1 1 1 3 3 3 3 3 1 1 0
0 3 3 3 1 1 1 1 1 3 3 3 3 1 1 3 1 1 1 1 1 1 1 1 3 3 3 3 3 1 1 3 3 1 1 1 1 1 1 1 3 3 3 3 3 1 1 0
0 1 1 1 1 1 1 4 16 1 1 1 1 1 1 3 1 1 1 1 1 1 1 1 3 3 3 3 3 1 1 3 3 1 1 1 1 1 1 1 3 3 3 3 3 1 1 0
0 3 3 3 1 1 1 1 1 3 3 3 1 3 3 3 1 1 1 1 1 1 1 1 3 3 3 3 3 1 1 3 3 1 1 1 1 1 1 1 3 3 3 3 3 1 1 0
0 1 1 1 1 1 1 1 1 1 1 1 1 1 1 3 1 1 1 1 1 1 1 1 3 3 3 3 3 1 1 3 3 1 1 1 1 1 1 1 3 3 3 3 3 1 1 0
0 6 6 6 6 6 6 8 8 8 8 8 2 3 2 1 1 1 1 1 1 1 1 1 3 3 3 3 3 1 1 3 3 1 1 1 1 1 1 1 3 3 3 3 3 1 1 0
0 6 5 5 5 5 6 2 2 2 2 2 2 3 2 1 1 1 1 1 1 1 1 1 3 3 3 3 3 1 1 3 3 1 1 1 1 1 1 1 3 3 3 3 3 1 1 0
0 6 5 5 5 5 6 3 3 3 3 3 3 3 2 1 1 1 1 1 1 1 1 1 3 3 3 3 3 1 1 3 3 1 1 1 1 1 1 1 3 3 3 3 3 1 1 0
0 6 5 5 5 5 6 2 2 2 2 2 2 2 2 1 1 1 1 1 1 1 1 1 3 3 3 3 3 1 1 3 3 1 1 1 1 1 1 1 3 3 3 3 3 1 1 0
0 6 6 6 6 6 6 3 3 3 3 3 3 3 3 1 1 1 1 1 1 1 1 1 3 3 3 3 3 1 1 3 3 1 1 1 1 1 1 1 3 3 3 3 3 1 1 0
0 1 1 1 1 1 1 1 3 3 3 3 3 1 1 3 1 1 1 1 1 1 1 1 3 3 3 3 3 1 1 3 3 1 1 1 1 1 1 1 3 3 3 3 3 1 1 0
0 1 1 1 1 3 1 1 1 1 3 3 1 1 1 3 1 1 1 1 1 1 1 1 3 3 3 3 3 1 1 3 3 1 1 1 1 1 1 1 3 3 3 3 3 1 1 0
0 3 3 3 1 1 3 1 1 3 3 3 3 1 1 3 1 1 1 1 1 1 1 1 3 3 3 3 3 1 1 3 3 1 1 1 1 1 1 1 3 3 3 3 3 1 1 0
0 1 1 1 1 1 1 4 1 1 1 1 1 1 1 3 1 1 1 1 1 1 1 1 3 3 3 3 3 1 1 3 3 1 1 1 1 1 1 1 3 3 3 3 3 1 1 0
0 3 3 3 1 1 1 1 1 3 3 3 1 3 3 3 1 1 1 1 1 1 1 1 3 3 3 3 3 1 1 3 3 1 1 1 1 1 1 1 3 3 3 3 3 1 1 0
0 1 1 1 1 1 1 1 1 1 1 1 1 1 1 3 1 1 1 1 1 1 1 1 3 3 3 3 3 1 1 3 3 1 1 1 1 1 1 1 3 3 3 3 3 1 1 0
0 6 6 6 6 6 6 8 8 8 8 8 2 3 2 1 1 1 1 1 1 1 1 1 3 3 3 3 3 1 1 3 3 1 1 1 1 1 1 1 3 3 3 3 3 1 1 0
0 6 5 5 5 5 6 2 2 2 2 2 2 3 2 1 1 1 1 1 1 1 1 1 3 3 3 3 3 1 1 3 3 1 1 1 1 1 1 1 3 3 3 3 3 1 1 0
0 6 5 5 5 5 6 3 3 3 3 3 3 3 2 1 1 1 1 1 1 1 1 1 3 3 3 3 3 1 1 3 3 1 1 1 1 1 1 1 3 3 3 3 3 1 1 0
0 6 5 5 5 5 6 2 2 2 2 2 2 2 2 1 1 1 1 1 1 1 1 1 3 3 3 3 3 1 1 3 3 1 1 1 1 1 1 1 3 3 3 3 3 1 1 0
0 6 6 6 6 6 6 3 3 3 3 3 3 3 3 1 1 1 1 1 1 1 1 1 3 3 3 3 3 1 1 3 3 1 1 1 1 1 1 1 3 3 3 3 3 1 1 0
0 1 1 1 1 1 1 1 3 3 3 3 3 1 1 3 1 1 1 1 1 1 1 1 3 3 3 3 3 1 1 3 3 1 1 1 1 1 1 1 3 3 3 3 3 1 1 0
0 1 1 1 1 3 1 1 1 1 3 3 1 1 1 3 1 1 1 1 1 1 1 1 3 3 3 3 3 1 1 3 3 1 1 1 1 1 1 1 3 3 3 3 3 1 1 0
0 3 3 3 1 1 3 1 1 3 3 3 3 1 1 3 1 1 1 1 1 1 1 1 3 3 3 3 3 1 1 3 3 1 1 1 1 1 1 1 3 3 3 3 3 1 1 0
0 1 1 1 1 1 1 4 1 1 1 1 1 1 1 3 1 1 1 1 1 1 1 1 3 3 3 3 3 1 1 3 3 1 1 1 1 1 1 1 3 3 3 3 3 1 1 0
0 3 3 3 1 1 1 1 1 3 3 3 1 3 3 3 1 1 1 1 1 1 1 1 3 3 3 3 3 1 1 3 3 1 1 1 1 1 1 1 3 3 3 3 3 1 1 0
0 1 1 1 1 1 1 1 1 1 1 1 1 1 1 3 1 1 1 1 1 1 1 1 3 3 3 3 3 1 1 3 3 1 1 1 1 1 1 1 3 3 3 3 3 1 1 0
0 6 6 6 6 6 6 8 8 8 8 8 2 3 2 1 1 1 1 1 1 1 1 1 3 3 3 3 3 1 1 3 3 1 1 1 1 1 1 1 3 3 3 3 3 1 1 0
0 6 5 5 5 5 6 2 2 2 2 2 2 3 2 1 1 1 1 1 1 1 1 1 3 3 3 3 3 1 1 3 3 1 1 1 1 1 1 1 3 3 3 3 3 1 1 0
0 6 5 5 5 5 6 3 3 3 3 3 3 3 2 1 1 1 1 1 1 1 1 1 3 3 3 3 3 1 1 3 3 1 1 1 1 1 1 1 3 3 3 3 3 1 1 0
0 6 5 5 5 5 6 2 2 2 2 2 2 2 2 1 1 1 1 1 1 1 1 1 3 3 3 3 3 1 1 3 3 1 1 1 1 1 1 1 3 3 3 3 3 1 1 0
0 6 6 6 6 6 6 3 3 3 3 3 3 3 3 1 1 1 1 1 1 1 1 1 3 3 3 3 3 1 1 3 3 1 1 1 1 1 1 1 3 3 3 3 3 1 1 0
0 1 1 1 1 1 1 1 3 3 3 3 3 1 1 3 1 1 1 1 1 1 1 1 3 3 3 3 3 1 1 3 3 1 1 1 1 1 1 1 3 3 3 3 3 1 1 0
0 1 1 1 1 3 1 1 1 1 3 3 1 1 1 3 1 1 1 1 1 1 1 1 3 3 3 3 3 1 1 3 3 1 1 1 1 1 1 1 3 3 3 3 3 1 1 0
0 3 3 3 1 1 3 1 1 3 3 3 3 1 1 3 1 1 1 1 1 1 1 1 3 3 3 3 3 1 1 3 3 1 1 1 1 1 1 1 3 3 3 3 3 1 1 0
0 1 1 1 1 1 1 4 1 1 1 1 1 1 1 3 1 1 1 1 1 1 1 1 3 3 3 3 3 1 1 3 3 1 1 1 1 1 1 1 3 3 3 3 3 1 1 0
0 3 3 3 1 1 1 1 1 3 3 3 1 3 3 3 1 1 1 1 1 1 1 1 3 3 3 3 3 1 1 3 3 1 1 1 1 1 1 1 3 3 3 3 3 1 1 0
0 1 1 1 1 1 1 1 1 1 1 1 1 1 1 3 1 1 1 1 1 1 1 1 3 3 3 3 3 1 1 3 3 1 1 1 1 1 1 1 3 3 3 3 3 1 1 0
0 0 0 0 0 0 0 0 0 0 0 0 0 7 0 0 0 0 0 0 0 0 0 0 0 0 0 0 0 0 0 0 0 0 0 0 0 0 0 0 0 0 0 0 0 0 0 0