0 0 0 0 0 0 0 0 0 0 0 0 0 0 0 0
0 7 7 7 7 7 7 9 9 9 9 9 9 2 4 0
0 7 6 6 6 6 7 4 4 4 4 4 4 2 4 0
0 7 6 6 6 6 7 4 4 4 4 4 4 4 4 0
0 7 6 6 6 6 7 9 9 9 9 9 9 9 9 0
0 7 7 7 7 7 7 2 2 2 2 2 2 2 2 0
0 2 2 2 2 2 2 2 2 2 2 2 2 2 2 0
0 2 2 2 2 2 2 2 2 2 2 2 2 2 2 0
0 2 2 2 2 2 2 2 2 2 2 2 2 2 2 0
0 2 2 2 2 2 2 5 2 2 2 2 2 2 2 0
0 2 2 2 2 2 2 2 2 2 2 2 2 2 2 0
0 0 0 0 0 0 0 0 0 0 0 0 0 0 0 0