0 0 0 0 0 0 0 0 0 0 0 0 0 7 0 0
0 6 6 6 6 6 6 8 8 8 8 8 2 3 2 0
0 6 5 5 5 5 6 2 2 2 2 2 2 3 2 0
0 6 5 5 5 5 6 3 3 3 3 3 3 3 2 0
0 6 5 5 5 5 6 2 2 2 2 2 2 2 2 0
0 6 6 6 6 6 6 3 3 3 3 3 3 3 3 0
0 1 1 1 1 1 1 1 3 3 3 3 3 1 1 0
0 1 1 1 1 3 1 1 1 1 3 3 1 1 1 0
0 3 3 3 1 1 3 1 1 3 3 3 3 1 1 0
0 1 1 1 1 1 1 4 1 1 1 1 1 1 1 0
0 3 3 3 1 1 1 1 1 3 3 3 1 3 3 0
0 0 0 0 0 0 0 0 0 0 0 0 0 0 0 0